10 10
##########
#    #   #
#    # G #
#    #   #
#    #####
###      #
#   #    #
# L #    #
#   #    #
##########
