12 10
############
#          #
#          #
#          #
#          #
#          #
#          #
# L      G #
#          #
############
